#################################################################################
#################################################################################
#################################################################################
#################......##########################################################
#################......##########################################################
#################......#......###################################################
#################......#..##..###################################################
#################......#......#####################.....##.....##################
#################.............#####################.....##.....##################
########################..##..#####################.....##.....##################
###########.....##.....#......#####################............##################
###########.....##.....#......#####################............##################
###########.....##.....#..##...................................##################
###########............#......#####################............##################
###########............#####.######################............##################
###########............####............#######################.##################
###########............####............#######################.##################
###########........................##..#######################.##################
##############.############..#......#..#######################.##################
##############.############............#######################.##################
##############.############............#######################.##################
##############.############............#######################.##################
######............#########............#######################.##################
######............#########..#......#..#######################.##################
######............#########..##....##..#######################.##################
######............#########............#######################.##################
######............#########............#######################.##################
######............##########################################............#########
######............##########################################............#########
######............##########################################...#....##..#########
##############.#############################################.........#..#########
##############.###..........################################............#########
##############.###..........################################............#########
##############.###..........################################............#########
##############.....................#########################............#########
##################..........######.#########################.........#..#########
##################..........####.....##.....################...#....##..#########
################################.....##.....################............#########
#......#########################.....##.....################............#########
#..##..#########################............##################.##################
#......#########################............##################.##################
#......#########################............###########.........#################
#..##..#########################............###########.#.......#################
#......#######################..............###########.........#################
#......#######################.########################.........#################
#..##..#######################.########################.........#################
#..............................########################.........#################
##############################.########################.........#################
##############################.########################.#.....#.#################
###################............########################.........#################
###################............##################################################
###################............##################################################
###################............##################################################
###################............##################################################
###################.....##.....##################################################
###################.....##.....##################################################
###################.....##.....##################################################
#################################################################################
#################################################################################
#################################################################################
#################################################################################
#################################################################################
#################################################################################
#################################################################################
#################################################################################
#################################################################################
#################################################################################
#################################################################################
#################################################################################
#################################################################################
#################################################################################
#################################################################################
#################################################################################
#################################################################################
#################################################################################
#################################################################################
#################################################################################
#################################################################################
#################################################################################
#################################################################################
#################################################################################
