#######################################################################
################################............###########################
################################............###########################
############################......##....##..#...........###############
###########..........#######.###..#......#..#...........###############
###########..........#######.###...........................############
##......###..........#######.###............#...........##.############
##..##..###..........#######.###............#...........##.############
##......###..........#######.###............#...........##.############
##...................#######.###..#......#..#...........##.############
##..##..##########.#########.###..##....##..##############.############
##......##########.#########.###............####............###########
##......##########.#########.###............####............###########
##..##..##########.#########.###################............###########
##......##..........###..........###############............###########
##########..........###..........###############............###########
##########..........###..........###############............###########
##########.......................###############............###########
##########..........###..........###############............###########
##########..........###..........######################################
################################.######################################
################################.######################################
################################.######################################
################################.######################################
################################.######################################
#########################............##################################
#########################............##################################
#############..........##............##################################
#############..........##............##################################
#############..........##............##################################
#############........................##################################
#############..........##.....##.....##################################
#############..........##.....##.....##################################
####################.##################################################
####################.##################################################
####################.##################################################
####################.##################################################
####################.##################################################
####################.##################################################
##..........#.....##.....##############################################
##..........#.....##.....##############################################
##.......................##############################################
##..........#............##############################################
##..........#............##############################################
##..........#...................................#######################
#############............######################.#######################
#############............####################...........###############
#############################################...........###############
#############################################...........###############
#############################################...........###############
#############################################...........###############
#############################################...........###############
#############################################...........###############
#######################################################################
#######################################################################
#######################################################################
#######################################################################
#######################################################################
#######################################################################
#######################################################################
#######################################################################
#######################################################################
#######################################################################
#######################################################################
#######################################################################
#######################################################################
#######################################################################
#######################################################################
#######################################################################
#######################################################################
#######################################################################
